#######
#...#.#
#.....#
#@OO..#
#..O..#
#.....#
#######